N ./path_to_the_north_texture

WE ./path_to_the_west_texture
EA ./path_to_the_east_texture

F 0,100,0


C 225,55,0

S ./path_to_the_south_texture

11111
10001
10001
10N01
11111
